16 10 10 3 23 14 200
0 4 0 0 0 0 
0 0 0 0 0 0 0 0 0 0 0 0 0 0 0 0 0 0 0 0 0 0 0 0 
0 0 0 0 0 0 0 0 0 0 0 0 0 0 0 0 0 0 0 0 0 0 0 0 
0 0 0 0 0 0 0 0 0 0 0 0 0 0 0 0 0 0 0 0 0 0 0 0 
0 0 0 0 0 0 0 0 0 0 8 0 0 0 0 0 0 0 0 0 0 0 0 0 
0 0 0 0 0 0 0 0 0 0 3 3 3 3 0 0 0 0 0 0 0 0 0 0 
0 0 0 0 0 0 0 0 0 0 0 0 0 0 0 0 0 0 0 0 0 0 0 0 
0 0 0 0 0 0 0 3 3 3 3 3 3 3 3 3 3 0 0 0 0 0 0 0 
0 0 0 0 0 0 0 0 0 0 0 0 0 0 0 0 0 0 0 0 0 0 0 0 
0 0 0 3 3 3 3 3 3 3 0 0 0 0 3 3 3 0 0 3 3 0 0 0 
0 0 0 0 3 3 3 3 0 0 0 0 0 0 0 0 3 3 3 3 0 0 0 0 
0 0 0 0 0 0 0 0 0 3 3 3 3 3 3 0 0 0 0 0 0 0 0 0 
0 0 0 0 0 0 0 0 0 0 0 0 0 0 0 0 0 0 0 0 0 0 0 0 
0 0 0 0 0 0 3 3 3 3 3 3 3 3 3 4 3 3 0 0 0 0 0 0 
0 0 0 0 0 3 3 3 4 3 3 4 3 4 4 4 4 3 3 0 0 0 0 0 
0 0 0 0 3 3 3 4 4 4 3 4 4 3 4 4 4 4 3 3 0 0 0 9 
4 3 3 3 4 3 4 4 4 4 4 4 4 4 4 4 4 4 4 3 3 3 3 3