20 15 1 2 11 13 200
2 0 0 2 0 0 
0 0 0 0 0 0 0 0 0 0 0 0 0 0 0 0 0 0 0 0 0 0 0 0 
0 0 0 0 0 0 0 0 0 0 0 0 0 0 0 0 0 0 0 0 0 0 0 0 
0 8 0 0 0 0 0 0 0 0 0 0 0 0 0 0 0 0 0 0 0 0 0 0 
3 3 3 0 0 0 0 0 0 0 0 0 0 0 0 0 0 0 0 0 0 0 0 0 
4 4 3 0 0 0 0 0 0 0 0 0 0 0 0 0 0 0 0 0 0 4 0 0 
4 4 4 3 3 3 3 3 3 3 3 4 3 3 3 3 3 3 4 3 4 4 0 0 
0 0 0 0 3 0 4 0 3 0 3 0 3 0 3 0 4 0 3 0 3 4 0 0 
0 0 0 0 3 0 3 0 4 0 4 0 3 0 3 0 3 0 3 0 3 0 0 0 
0 0 0 0 4 0 3 0 3 0 3 0 3 0 3 0 4 0 3 0 3 0 0 0 
0 0 0 0 3 0 3 0 4 0 3 0 3 0 4 0 3 0 3 0 3 0 0 0 
0 0 0 3 3 0 3 0 3 0 4 0 3 0 3 0 3 0 3 0 3 3 0 0 
0 0 3 3 3 3 3 3 3 3 3 3 4 3 3 3 3 3 3 3 3 3 3 0 
0 3 3 3 3 0 0 0 0 3 0 0 3 0 0 0 0 0 3 0 3 3 3 3 
3 3 3 3 3 0 3 0 3 0 0 9 4 0 0 3 0 0 0 0 3 3 3 3 
3 3 3 3 3 3 3 3 3 3 3 4 4 4 3 3 3 3 3 3 3 3 3 3 
3 3 3 3 3 3 3 3 3 3 3 3 3 3 3 3 3 3 3 3 3 3 3 3 