18 10 16 3 21 9 200
1 1 1 0 1 1 
0 0 0 0 0 0 0 0 0 0 0 0 0 0 0 0 0 0 0 0 0 0 0 0 
0 0 0 0 0 0 0 0 0 0 0 0 0 0 0 0 0 0 0 0 0 0 0 0 
0 0 0 0 0 0 0 0 0 0 0 0 0 0 0 0 0 0 0 0 0 0 0 0 
0 0 0 0 0 0 0 0 0 0 0 0 0 0 0 0 8 0 0 0 0 0 3 3 
0 0 0 0 0 0 0 0 0 0 0 4 0 0 4 3 3 3 3 3 3 3 3 3 
0 0 0 0 0 0 0 0 0 0 3 4 0 0 4 0 0 0 3 3 3 0 0 3 
0 0 0 0 0 0 0 0 0 3 3 4 0 0 4 0 3 3 3 3 3 3 3 3 
3 3 3 3 3 3 0 0 3 3 3 4 0 0 4 0 3 0 0 0 0 0 0 3 
3 3 3 3 0 0 0 3 3 3 3 4 0 0 4 0 3 3 3 3 0 0 0 3 
3 3 3 3 0 0 3 3 3 3 3 4 0 0 4 0 3 3 3 3 0 9 0 3 
3 3 3 3 0 3 3 3 3 3 3 4 4 4 4 0 3 3 3 3 3 3 3 3 
3 3 3 3 0 0 0 0 0 0 0 0 0 0 0 0 3 3 3 3 3 3 3 3 
3 3 3 3 3 3 3 3 3 3 3 3 3 3 3 3 3 3 3 3 3 3 3 3 
3 3 3 3 3 3 3 3 3 3 3 3 3 3 3 3 3 3 3 3 3 3 3 3 
0 0 0 0 0 0 0 0 0 0 0 0 0 0 0 0 0 0 0 0 0 0 0 0 
0 0 0 0 0 0 0 0 0 0 0 0 0 0 0 0 0 0 0 0 0 0 0 0